%%%%%%%%%%%%
%         G%
%      %%%%%
%  G       %
%P        G%
%%%%%%%%%%%%
% % % %%%%%%
%%%%%%%%%%%%
