%%%%%%%%%%%%
%         G%
%          %
%    G     %
%P         %
%%%%%%%%%%%%
% % %%%%%%%%
%%%%%%%%%%%%
