%%%%%%%%%%%%%%%
%G           G%
%%%%%     %%%%%
%.          ..%
%P        G   %
%%%%%%%%%%%%%%%
% % % %%%%%%%%%
%%%%%%%%%%%%%%%
