%%%%%%%%%%
%G       %
%        %
%        %
%       P%
%%%%%%%%%%
% %%%%%%%%
%%%%%%%%%%
